000002222222220000
000002111111120000
000002111311120000
000002111111120000
000002111111120000
000002221112220000
000000021112000000
000000021112000000
000000021112000000
000000021112000000
002222221112222200
002111111111111200
002114111111111200
002111111411141200
002111111111111200
002114111111111200
002111111111111200
002111111111411200
002222222222222200
